1111111
10C0C01
10P00E1
11111111