11111111111111111111111111111
1P00000C000000110000100000001
100000100000C0000001000000001
1C0000000010000110000E0000001
10000000000000000000000000001
10011110000000000001111000001
100000000000C0000000C00000001
10000000000000000000000000001
11111111111111111111111111111