11111111
10C0C001
10P10E01
10000C01
1C000111
11111111